######
#----#
#-@*-#
#o---#
######